======================================================================================
======================================================================================
===...^^===###========================================================================
==.....##~#####=======================================================================
==..++..#~.#####^^^^^^^^.=============================================================
==@++...~~..#####^^^^^^...============================================================
==..+...~.............^^^=============================================================
===.+..~~~~~~~~.....####==============================================================
===.++.~......~~~~.###================================================================
=====..~##^......~~~~~================================================================
======^~^^^^#....####^================================================================
=======~~^^###.^.###==================================================================
====#===~~~~~~========================================================================
===###====~~~~========================================================================
===.....=~~###======..================================================================
==...####~#####===..............................======================================
===.#####~.#####^^..^^^^.............................###.........=====================
===##..##~..#####^.##^^...........................#########....=======================
==..##^^#~~........###^^^.=======..........#........######...........=================
===###^###~~~~~.....####.=============.........#......###.......##.......=============
===######.....~~~~.###=================..............................~~~~=============
=====#####^......~~~~~==================...#........................~~~~~~~===========
======^~^^^^#....####^=================...........................~~~.....============
=========^^###.^.###================............######...........~~..........=========
===================================...............^^^###........~~.........===========
====================================....#......#^^^^^^###......~~........=============
=====================================.........####^^^###.....#~~........==============
======================================.........####^####....##~~.....=================
=====================================............#####.....###~~......================
====================================.....................####~~....===================
====================...===========.....................#####~~....====================
==================........=====.......#####################~~.....====================
================....####...................#######..~~~~~~~~.....=====================
================...#####...........................~~~~~~~~....=======================
=================....##.........###...............~~.........=========================
===================....................^.........~~.........==========================
======================......#....^.............======....=============================
========================.....#.............===========================================
============================............==============================================
======================================================================================
======================================================================================
======================================================================================
